{
	"version_major":1,
	"version_minor":0,
	"version_patch":0,

	"char_width":2,
	"char_height":1,

	"width":30,
	"height":32,

	"ruler_column_line_head":1,
	"ruler_column_line_tail":1,
	"ruler_row_char_head":1,
	"ruler_row_char_tail":0,
	"back_slash_char":"!",

	"tile":[
		" 1 2 3 4 5 6 7 8 9 0 1 2 3 4 5 6 7 8 9 0 1 2 3 4 5 6 7 8 9 0 ",
		"1~ ~ ~ ~.~.~.. , . .o, .o                                    ",
		"2~ ~ ~ ~.~.~.. . . .o.o.o                                    ",
		"3~ ~ ~ ~.~.~.. . . .o.o.o                                    ",
		"4~ ~ ~ ~.~.~.. . . .o.o.o                                    ",

		"5~ ~ ~ ()~|~....o..[]~ []                                    ",
		"6~ ~ ~ ()~|~.......][][][                                    ",
		"7~ ~ ~ ()~|~.......[][][]                                    ",
		"8~ ~ ~ ()~|~.......][][][                                    ",

		"9, , , ,,, ,,.o, ++...o..                                    ",
		"0, , , ,,,,,,+----+......                                    ",
		"1, , , ,,,,,,+....+......                                    ",
		"2, , , ,,,,,,+----+......                                    ",

		"3. . . ...o.....o.....o..                                    ",
		"4. . . ..................                                    ",
		"5. . . ..................                                    ",
		"6. . . ..................                                    ",

		"7##                                                          ",
		"8######                                                      ",
		"9######                                                      ",
		"0######                                                      ",

		"1######                                                      ",
		"2######                                                      ",
		"3    ##                                                      ",
		"4######                                                      ",

		"5                                                            ",
		"6                                                            ",
		"7                                                            ",
		"8                                                            ",

		"9                                                            ",
		"0                                                            ",
		"1                                                            ",
		"2                                                            ",
		" 1 2 3 4 5 6 7 8 9 0 1 2 3 4 5 6 7 8 9 0 1 2 3 4 5 6 7 8 9 0 ",
	],
	//r g b c m y w k R G B C M Y W K 
	"color":[
	],
}
